hic, haec, hoc — этот
ille, illa, illud — тот
is, ea, id — тот
nos — мы
noster, nostra, nostrum — наш
qui, quae, quod — который
sui — себя
suus, sua, suum — свой
tu — ты 
facilis — легкий, нетрудный
is, ea, id — тот
mălus — плохой, злой
mălum — зло
mālum — яблоко
mālus — яблоня
nullus — никакой
quicumque, quaecumque, quodcumque — какой бы ни, всякий
severus — строгий
sol — солнце
solus — один, одинокий
uterque, utraque, utrumque — и тот и другой 
aper — (дикий) кабан
bellus — хороший, симпатичный
ceno, cenavi, cenatum — обедать, пировать
conviva — сотрапезник
sine — без
Titus — Тит
Caecilianus — Цецилиан 
a, ab — от, со стороны
absum, abfui, abesse – находиться далеко
ad – к
alius – другой
animus – дыхание, душа, дух
appello — называть
Aquintani – аквитаны
Aquitania — Аквитания
atque – и
attingo, attigi, attactum – прикасаться к, прилегать к
aut – или
Belgae – белги
bellum – война
capio, cepi, captum — брать
causa — причина
Celtae – кельты
commeo – периодически ездить и возвращаться
contendo, contendi, contentum – спорить, бороться
continenter – непрерывно
contineo, continui, contentum – удерживать, оганичивать
cotidianus — ежедневный
cultus – обработка, почитание, культ, культура
de – от
differo, distuli, dilatum, differre — различаться
divido, divisi, divisum – разделять, отделять
effemino – делать женоподобным
etiam – также, даже
extremus — крайний
fere – почти, почти всегда
finis – конец, край, цель
flumen – река
fortis – храбрый, крепкий
Galli — галлы
Garumna – Гарунна (совр. Гаронна)
Germani – германцы
gero, gessi, gestum – вести, проделывать
Helvetii — гельветы
humanitas – образованность, культурность
importo — ввозить
incolo, incolui, incultum – населять, обитать
inferior — нижний
initium — начало
inter — между
lex, legis — закон
lingua – язык
Matrona – Матрона (совр. Марна)
mercator – купец
mons, montis — гора
obtineo, obtinui, obtentum – захватывать, владеть
Oceanus — Океан
omnis – весь
orior, ortus sum – рождаться, возникать, начинаться
pars, partis – часть
pertineo, pertinui — простираться вплоть до; относиться
praecedo, praecessi, praecessum – идти впереди, превосходить
proelium – сражение
prohibeo, prohibui, prohibitum – не пускать, удерживать в стороне от 
propterea – потому
provincia – провинция (особ. провинция Нарбонская Галлия, совр. Прованс)
proximus – ближайший
Pyrenaeus — Пиренейский
quoque – также
reliquus – прочий, остальной
Rhenus – Рейн
Rhodanus – Родан (совр. Рона)
saepe – часто
septentrio, septentriones – север
specto — глядеть
tertius – третий
trans – через, по ту сторону
tres, triа – три
unus – один
vergo – быть обращенным (в какую-то сторону); клониться (к)
virtus, vitutis – доблесть, добродетель 
